33333333333333333333333333333333333333333333333333333333333333333333333333333333
3                                                                              3
39      3                       3       3               333                    3
333333333333333333443443344433333333333333333444  33333333333344433333333      3
3                                              3  3                            3
3                                  3        3  3  3                            3
3                                 33        33  44                             3
3                                333        333                                3
33333333333333333333333333333333333344444443333333333333333333333333333333444443
3                                                                              3
3                                                                              3
3                                                                              3
3                                                                              3
3                                                                              3
3                                                                              3
3                                                                              3
3                                                                              3
3                                                                              3
3                                                                              3
3                                                                              3
3                                                                              3
3                                                                              3
3                                                                              3
33333333333333333333333333333333333333333333333333333333333333333333333333333333